[
    {
        "id": "1-1",
        "data": [
            "00000111",
            "01010002",
            "01210111",
            "01110002",
            "00010111",
            "03010002",
            "00010111",
            "11110002"
        ]
    }
]